>Rosalind_2491
ATACGTTTGTGGTTAGTTTGTTGGCGAACTAGTTAGCACATGAAGCTTAGATAGAGAAAC
CTTAATTAGAAGGTTAGGGTCACAGTCCACATTGCATGGAAATTATGGACCCTCGAGCCC
AGTGTCGAGCCGGATCCGTCGGAACTGCTACTAGATGCCACACCCGGACGGCGTTCGGTG
GCTCCAAGCAAAGTGTGCACAGCCGGCACTTCTTAGACTTTCCGGTCACGCAAGGCGAAA
GGAGCCCGTGCTTTCAGTTCGCCACGTAACCCCACGTTAGCTCGGCTGCACCGCCATCTC
TAGGACTTACACCTCTGGACCAGTAAACTGTACGGATACGTCTTGAATTGCATCACGTGC
TTAATCTCGGGTTTACTAAAGATCACATTCCAGTGTCTTTTTCTGGTTTGCTGACCAAAT
GTCAAATCATTAGCAACAGCCCACATGGCAACAGCGGAAATTATTCTGCAACCCAAACAT
TTGAAAGTTAAGGCAACCAGCGATAATATGAACGTATTCTCTTAAGCGATATTATAGGTG
CATGATGCGGGTCGCTTAGTCCCACCGGGGGAACCACAGTCGCGCTTCATACTCGCTTTA
AACTTAATTTTACGCGCGACCAGCACGAACAGGTTCAGCTCAGAATTCATTTCCTGAACT
GGAAGTCAGGCTGTGTCACTCGGGGTCCCAAATGTACGTCACAAGATAGCATTTAAACGA
GGACCTCACACACGGCGACGAACAACATCGCCAACAAAACTTCGGGTTAAAGATCCTGGC
GTGCCGGACAATACCACGCCCACACATCAAACGGTAACTTGCAGAGCACGGCATAAAGGA
AAGCACTGCCGC
>Rosalind_3720
ACGAGTTAACGTTCCGTTGCTGAATGGTTGACCCAACACTGAGGCCAACGAGGTACGCAA
GAGAATGGAGTAGAGCCTGCCGAGTCGGGCACTCCCAGTAAGGAAGATAGAGTAACAATA
TGCCCGGCGACATGCCGAATTTTGGAAAGTTTGGTACTAACTGTATTACATTCGCTAGAC
TTTCGCGTTGACGCATCGCATGGACGCCTCCATCGAAACTCCTACAGGATCACTTTCCGA
TCGGTTGGGCATCTGTCTTAAGTACTGTAGTGTCCTTAGGCCGCCCCAATAATCGCTCAG
GGCGGCGGCCGTCCGCCCCTAGCGATCGGTGTAAAGAAGCCACTGGGCGCCGGCGCATGA
CTCTCTCTAGTTCGCAGATAGAGGTTTCATGGATAATAGAGCCTAATGCCCCGATTAGGC
CCACATTAATATCACCTTCCGAAATGAGAGGAAAATTCTCGAGCAGGGTATGGCGCCCTA
ACGGGGGCCAGCGAGTTGACACGGACGGCGGTTGTTGCGGATGTGGAGCCGGAAGTCGTA
TCAGGTCATCATGCAGACACACATCCTGGCTCACATAGCCCTCGCTAGACCACCCATGAG
AGGATGGGCTTCTCTAAACCACAAGGCTGCTTCATTCCGACGATGTGTCAAGACCAGTGG
TAGATTAAAGTTCGACACCTATGTCTGTTCGATTAGCTCCATGAGTCTGGTGCTTACTGC
GTTCGCGAGGGTACCGGAATCATTTTTCGGCCCTCCCCGCATTCATACCGGATGTGAGAG
GAGCCAGTGCATTCGTTCCCCAGTGTGTGTACACGATATCCAGCGCGTCTGCCTTACGAC
CCCGCAGCTAGACGGGCCCGCATCGGAAAGTGAGTCTCCGGTCATGACTTGAAAAGGGGG
TGATCTGTAGAAGTACTCGTATTGTA
>Rosalind_1141
CGCCACTGGATAGTTCGTGCGTATTCTACAGTAATCAGGATTAAGTGAAGTTCTGTCGGC
GGCGATCTCCACCGCTGACTTCACCATCGACCCTGCGCATAGCATACCGTGCCCATAATC
GAAACAAAGATGTTTTCAGTTCGGCTTTCCCCACAGCTCCAACGGATGTTATTGTCTGCA
TCTGCGAAGTGCACTCGATTTGGTAGGCGAACTAGACTCCGGTATTAATGAAAGGCCTAG
GCGGGGGCCCAAATCGGATTCTAATCGTTGCAGAGCGCCAGGATTCGAGAGACTTGCTGT
ACCCCGTGGGGCAAGCACGCCGGACCTCCGACCTTGCCAACTGGGCTAGTGCCACCGCAA
ATATCCAGCGATTACTGGTCCTGTGTAAACCAATTGAATTTATCATTTCAGCCAAGGCGG
CCCCAACTTATTCCCAACAACAACGATACGTCGCTGAATCGAAGCCGAAACATCAACTTG
TCATACTAGACCGCTAGTCCTTGTCCTTCGTGCCTTCCTCTCCGGAGCTAATAGCAGAAG
GATGGAGGTGTTGACTTGAGGGAGTCGTGCCCTAAACAGAAGTAAGCTTCCAAGGCTGGG
GCGACAAACGGTAACACACCTTCGAACACGAACTTGACGTCTAGGTTCTCAAACAGAGGA
GGATAGATTAAAGGTTCGACCTCTCCAGCGGATTTGTTTCCGCGGGGAGTTAATCTATCA
CTTCAATCGCTTTGCAACTAGACGAAGTTTGGGAGGGCTCCGGACGGTAAAATCCCAGTG
GCTAGCCTTGCTGCCGATCCTTGAGCACATGATTTAGAATAGCTAGATCTAGTCCAAAAT
A
>Rosalind_3184
CTGTTTGGCACCGAAAGGCAGACGGAGTATGCAAATTTTAGGCATCCGAAGACTCAGTAC
AGGTAGCTGGTATAGGATTACCCGGATCCGCCCACATGACGCAGGAACCGCCGTCGTATA
AGTGGATGGCTACAAAGATCGGCCAACTCGGGGGTATTTAACACATCTCGATAGCGCGAC
CACTCCCGCAGAGGGAAACGCATGGAATTAGACAGACATGGAGTCAGACTGAGCGTTGAG
GACGCGCATGTTCCAGTCCGTATATATGCAATGGTTGATACTTTTAGCTCCGAATATTCT
GTCCCCAACCCTATAACTGCGTTTGCGGTGTGAGGGGTTGGCTGCGAGGCACCAGAGACT
TCTGAGGGATCGGGGGCTGGGCACTTTTTGAAAACCCTTCCCATGTGGACTAGGATACCC
ATGCAGCAATCGGCACGATTAAGAAACTTACCAGGGAACCTTAGACCTGGTGTTAACAGC
CGACCTGATCTCTTGCTTGTATTTAAGTTAGATATACTGTTATGGTAAGCTTTCAGTGGA
TAACACCGTGAAAATTTTGCTGACGACGTGTATACATACGTAGTCCAGCCCGAAACTAAG
TTCGTAATAAAGGGCCTCTTGTTTGGCCGCCGGTACCTATAGTCATGACGCGGCTAGCAG
TAACGCGCGCTATTAGACATCGGTTGAAAGTTAGAAGCGGATCCATCAAGTGTGTGTACC
GCTACGTTTCACCTGAGCAGAGCTATGGGGGGGACTGCTCCAGGCTCGAGTGGCCACCCG
GCAGACATGACAGTCCATGTTCACTCGCGGACAAACGGTGGGACTTTTGAACCCTGTATG
CCATTTCTTGTCGGGCTGGTGATCCTGTGACAAGACCGAAGGGGAACAGTGATAAACAGT
ACTCTCATCCCAGCATACTTCTTTAACATCCTATTCGGGAATACAGCCGTAGCTGGACGA
TGTCACCGGGGACGTTAGACGTAT
>Rosalind_6449
AGTAAGGGCTCGAATAACCGCACACGCGTAGCGCTTTTTAGTTTTACAAACCTATAAAGA
CGGTTGAGCCTAGAGATCGGACGTAGTGGGTGACAGTAAACCACGGAGCTACGAAACTAA
GCCTGCGATAGTTAGTGATTTTGGAAACCATTAACTTCTAGAGAACACAATACCCAAAAT
GCACGTAACGACGCGTTGCTTGCAAACGCCAGGACAGGATGAGAGGCCATGGTTCTGAAA
CGTATTAGAAAAGCTTCTTCGACTGGGCGGATTGGCGGGGTTGAAACGGGCTTTCTAGCC
CCACCAACTAAACCTAACGCGTGCGGTTCGCTTGATAGTAGGAGGGAGCGTGGCAAACAG
GTCAACAGAGAACAGTCGTGTTTCGCCTGAGCCCTGCGCAGTGAACGAGCCCAATAGCGT
TGTTACAATTTAGGGCAACTGCGACTCAAGTTAATCTCTCTACTCATCGAACTAAGGCAT
ATGTGGGTCCACTACAATCGGAGCTTTTCGAAGAAGTCAAATCGAAGGCAAAAATTTCGC
TACTCGACCGTACCAATTCTTGTGCCTACCATCAGTAGGGCTTTACACCTCCTACGCACT
CGGTGACAGTAGCGAAATATGCACCGCACTACAAAAATTGACCATACGTTCGCATTTATG
GAGAGTCGAACGTCTAACAATTGTCCAGCGTGTAGCGCCCTGGAACGTCGTAGGGACGAC
ACTCTAGGAAGAAGTAAATTGACAAACGTCTTTCAATGAACTGAGCGCGACTACTCATGA
CCATCAAAACGGATATGAACCATCGGGTACGACCATTACTCTTGAGTTAATCAGGAGCTT
AGATTAACGACAGTAGGTATACTGGGTTAAGTTTAAAGGAACAGTGTCCCTTGGCTCATC
TGAATACGTTAGGGCCAATTCGAGCCGCCAATTCTGTCCTCCAAGTATAAGGCGACGAAG
TGAAGAACATTCTCATTACCCTTCCCCTCGCTTTCGGCAT
>Rosalind_7965
CGTCTCTAGGTGATGCCTGATCGGTCCAGTCTGCCAACGTTTGGACGTATTAGCCGGACA
ACCTTCGGGCTACAATCCGACGTATAACAGTACATTAAACCGTTTGAAATCAGCTTCTAG
TAATTGTCGACGTCAAGCAAATGCTGAACGGTCTGTCGTGTCGTGTCGCTTGTAGGCTAC
GTACTGCACTGCAAACTGCTTACCGCGAACGTCAGAGAACCGCAACTCGAGTTACAACTA
CGCGAGGATGAGCGTACCAACTGCGTTTGGCTACCGCAAGTTGTGACATGCAACTCGTTT
GCGTTAATTAGTCTCCTCATCTGAGTTACGGATCACGGCCTCGGGCGATCTACGGCTACT
CCATTATTCAGTCACTATGGTTCTCTTTTTTATCATTGCTCGGCGCTAGCTGACACTTTA
GTACCTTAGGATTATCGTGATAAGGTGATTCAAACCATAACATATGGGTCTCCCAAGAGC
CTGTCACGAATATCCGACTACCCTTCACTGTGTGGACCTGGGTGTGGCACCCTATGCTGG
ATCGATTGATGAAACAACCTAAAAACCGTAGAAGGCTATCTCGCCTCAAACAGTAGAGTC
CCTGCCGTGCGGCTGCGACGCGCCCAACAGCTGAGTGTCGCCAAGCGTGGATATGGGATT
GTGTCTCGAACTAACATCCATAATAGTATTCATATAGTGGCACTTCGTGTACATTAGCTT
CTTGGTCGCGAGATACCGTACGTCTGACGGTAAGAGGTATGTGGGCCTAGTAACCCGAGC
GCTCTTCTTGACAGGATCCCCGTACGTCCGCTTGATGGCATGTAACCGCTGTGGCCGCAA
CCGGGACCCAGTAATATTTAAGACCTATGACAGGATCCCAAGTCGGTATTGCCCCTCTGT
GGTACCCAGCTCCGCGAGGTATTTGTCA
>Rosalind_7045
ATGATTGAAACCCAGATTCGTTCGCAGCGCCCAAGAGCCACGCAACTTCAGCAATCCAGC
GCCTGTGAGGTAGAAGACCTGCAATTCCATACCCTTGGTATCCCCGTCAAAACCTGCGAC
TGTCCATATCCGACGACATCTCCGTCAGGTTTCACAGGAATAATCCTCCCACTCGGGGCA
AACACGCGTCGATCTTCTTTAGCCTTAATCCCATATGATCATCGCGACGTAGGTTTCAGA
TACAGACGCACGGGGTGCTGGACGCCAGCCACTCCAGTTGTGAGTCGGTCGCTATTCCTG
TTGACCGTTGGACAGAGGGTGTCCAACCAAAAGCTGTTAGGTAGCGATCGGTAGTCATGG
GCGACATAGAATCGTAGCCAAGTAGGTATATGTTGTGATTAGTATTAGTGAATCTTAAGC
GTTCTTTTACCTTAACGTTAAATTTCAGACGCATGGGCTGAGACGCGGCAATACATCCGG
GTCATGGGCACGCGGTAGCTCCGGACGATAACTCCGTGGTAACCTGAAAATCGCGTACTT
GGGGTCCATTGTGATACGTGTCTATATTAACTCGTGCTTTGCTTCTAGTGCTTAGGGATC
CCGCCTGGCTGTAAAGGACTCTACTTTTCGGCTGCCTATTGATAGCCGATAGACTTTGTA
AGTGCGCAATATATACTATCTTCTTTCCTAGTGACACTAACGTCTCTCAAGTGGTGCCAA
AAAAAGAAGATACCTCTTCACGATAGCCGAGGTCAACGTCCACCCGGCCTCGACTAGAAA
GAGCCTCATGCGCACGATTTTTGACGGACATACAATGTGTAAGCCTTGCTGTTCGAAATT
AGGGCTCGGCTACGATCTCTCGCACATGTCTCGCCCCAAACTCCACGAGATTTCGCAATT
TTAGTACGTATCTACCCTCATTAAATATTTTCTATCATGTGTACTCAGTTAATTTTGGTT
TACAGGGCAGCAACAGGTATACTCACCCCGGG
>Rosalind_0237
AAAGCATTAATTTAGTTTCTTCGTGCCTCTACCGGAACGGTGGAGGGTCCCAGTCAACGT
TGTACGGGAAATCAACGTTGCGCTAGATTGAAAACACGAGGTACTCGGGAAATATGATAG
AGAATGGAGCTACTGCCTTCATTAATTCTCCGCCCCTGAAGTCTCACGTTCTTTGATCGA
GCCGTATCACCCTGGTATCAACGCTCGCAGTAGCCACACCCGGTCCACACATGCTCCACA
TTGGCTGGAACGTGGTAATCCCTTTGACACCTTCATACGCAGTATGTGGCTAACTAAGAG
ACGCATCGATATAAAAATAGCGAGTGGTTTCCTCGACGATAACAGCGTTCGAAGATTTAC
CACGATTCTGATGAGCCATAGCGGATCGTATATGGAGCCCCGATGAGAATAAAACTATAG
TCGAAACAGCGTTGAAGATGTTGCATCACCTGGTGGAGATCGAGGTCTGCGGCGTAAAGT
GCGCGCATCTGACCATACAGCGTTAGAAGATCCTATAGCGCACGGGCTGAGACGTGCCAG
TAGTGACTAGGAAAAACGGACGCATGTGTGAGCGTTCCGGGCGCAATTAATGATTTCGAG
TATCAGATCGTCCCCATGCCTCCAAGAGCGGCTGACCCGCCTGTCTACGCGGGTGCAATT
GATCTCGAAGGTGTTTCAAGTTGACCACGTAGAAATACAGCATTAAATACCTTAGATACC
TGCGGCCCTCACGATTTATTGCAGCGATAGGCAGATATAGGGAAATCGTGGCAATCGTAT
GGCAGTGAGCTACTACTGCCTTAGAATGTTATTCTGAAGGGGTCCGGTAGGACTAGAATG
AAGGACACGTTGTGTTACACTAAGAT
