>Rosalind_7549
GATATCCAGTTCGACTCCCTGCGATACACCTGGAGCCGCCACGGGAGGATGACCGACAGG
CGTAGGTGAAGCCCCACCAATACGCGCGCGGCTCAACATCCTAGTATACCCATTCTATAG
GTCCAATAAGCTGCCACGTACAGCCACATGCGCCAACTTGAAACTACAACTGGCTTTATT
ATACATATATTACGCTTTTTTTGCTAAGGTCGCTTTAATAACCCACAATCTGGATACTAG
GCGGAACAGTTAACCACAGGGGGCGATTAGATGTTATATTTGCAAGAATATTTTGGATTG
TGCATACTGACGTGGTTGCAGGTAACACAATGATCCCCCTGGTACAATGACGTTAGACTG
AGTGTTTCGGAGGGGGATCCGATGAACATGAGTTCGGACCCACAAGTTAGAAGGAGTATC
AGTTCTCGCGTGCAAGCGATCTAGGACAATCCACGCGACGGTTAGATTATTAGTACGAAT
TAGCGTGGCCGGCTTTCGCGTTCAACCCGCTTGTGGTCCGGCGATGACCCCGACAGATCG
AGAGCCGTTCGAGCTGATTTGGATTGCCACGGCAGCATTTCTGGCGAGTAGCGTTTGATT
ACCGCGTCACGCGGTTCAGAGCACTCGACGAATGCCCGGATACAGCAAACAGTGTTAAGT
ATTGATCCACGGTCCGTGGGGGCAACGGAGGATTTATGCAGTAGGTCTAAAGAACCCGTT
CTGCGCACTCCGCGCCCTATGTTTTCAACCCCTTCAGTGCTGAGTTTTTCGCTCCCGAAT
TAGTAAATGACGTAATACCCGGACTGTTGGCCACCCGAGCGAGCCGAGGCTTGGAAGATG
CTGTTCAACCGGAATTTGAGCACTTAATAAGTGGCTAAGGGCGCAGGATGCACACTGCAT
TGCCTTTCTGTACGTCCGTGATTGTTTTCCACTGCCGTAGGCTCGCACCGCTGCAT
>Rosalind_9078
GTGGTCCGCCAACACGGACGTGGGGTTAAGGTCACATGTTAGTAATACAACTGTCCTTAG
ATATCAGCCTAGGTGGGCCCAAAACTATCCCGCATATCGGAGGGCGAACTGGGTATACTG
TCGCCGGGCATCGCTCAGTCCCGTCGGCATACTCCCCAACGAAGATCAACACAGTAGAAT
AATCGGAATTGCCATTCCCAAAGGCAACTAGGGCTGGTTATTCTTAATGCGGCTTATTTG
CGGCATTTACGGTGTTTCGTCTCCCGGCCCCTCATACATGATATAAGAGCTCACCCTTCT
GTGGCTGTACAGATGTTCACATTGTCAGAAGGACCTCTATACTACTTATTTGTCCTAATC
ATTCGATAGTACGGATCTCACAATTCAATCTGAATGGGAGAAAAATCTGTCGTGACACAA
GGCATGGTCCTACAGCTGGGGGCGCAATCAGCCCGCAAATTTGTAAAACGAATCAATAAT
CTCGTACCGTGCGCACCGGTCAATAAATAGACATGGGTGCGGATTCCAGGCATCTATCCT
TCAAGGTCAGGATCCTGATTGTCTCATCGCAGCAATAGGTTAATGCCACCTTAGGGGGGC
TCAGGACCATCACGCTTAGGAAAGAATATGACGTGCGATCCTCAGTTAACATGGCGCTGC
AAGACATTATAATCTTCAACGTGTTTGAATGTGGGCACACCCGGCCTAGAACGAACAGAA
CGCATTTCATCACTCAATGAAACGGTGTGAGCTTATTGAACCCAATGCCGGAGCAATTGC
CTGACTCGATGGTATGTTGATCTACACCGGATAGGTGGGGCTTGCATTCAGCAGTGGAGG
TACTAGTATAGACACGACAGGGCTTACTGCTGTCGCTCACGGCTACGAATTTGAGTTGGT
AAATGTAGAAAGCAAATTCATCGGTCCGAGGTGCGCGGTCGGAGCCCGGTTATCCA
>Rosalind_5523
CAGGATACCGTTAACGAGATGAGGGGAAATAAGCTAAAGGTTCCCCACTTCCATTAGGAT
AAATAGCAGGGTACATTTCCAGCCCGAAGCAAGCGTAACAGGATTCTCCGTGGCAGTCCA
GTGTCCCGTTTAATCGTTAAACCGTCAGAAGCTCGGTTTGCGGTGACACATTCTGCTACT
AACGTGACTACCCGTGCGCGAATCTAATGGTTCCCGACGACTACATTAGTGCTTACTCGC
TATGTCGTTCACAGGACCGAACGAAATTGCTCAGGGTATAAAGTTTGGGAACCAGTTTTG
AGTTACATTAGCTGTGGTGATTAGGCCTTGGAAGTGATATCCGCGGAAAAATATTTTAAC
TCAACGTCTGCTTGAAAAGATCGGCCGCTCCAATGTGATCATACATTATTGGTCCAGCAG
TATATGGGTTTCAACGAGGCATACGTAGGTGGACTGTTCAGTCCGTAGGGGCCTGACCGT
CAGGGACATTGAATAGCCTCCATACTGCGTGATCGGCAAGTATTCAAGATGAGTTTAAAC
AGTGTTTGCCTGCTCCACTCAATAGTAGGCTGGGCATTGCCGATAAACGCCGAAAACATG
CTCATACGGTCTCTCCATACCGGAAGGCCGAGAATGGTGACGAACGCGACTCCTCGCCAC
ATATCTCTATCGATAAGGCACCGACTGTTTGCCCTTAGAGTCGTCTGTAGGTCTAACATG
TCTATCACTGGGAAGACCATGCTGTATTGGGTCCAATGTTATACAAAAATGACGGTTTGG
CCTTCGTTCACTTTTTCTATTTAGATCTCGATCGATGGCAATTTGTACGTGAGTCGATAG
TGATGTTATACAAAGTTGAAACTTTTCATGTCGCGTCTTGTATCTGGTCATTCCAGTAGG
ATCTCCCCCTGGTGATACAAGTATGAATTTATCAATTAGTTGCCGAGTGCGGTTGA
>Rosalind_5692
TTCGACACCTGGAAGGTCGTGTACAACGCACTATCCATCGTAATTGCCTTTTAGAGGTTA
TTGCAGCTCTATGACGTAGACCTTTGGAACGCGCCTACGAGATTCCCTCACCTCGCAAAT
ATTCCATACCTGCTATATGCCAACACGGCATACAGTAGAAGGTAATATCAGGTTGTCGAG
GCTCCAAGAAAAATTGCTTGCCTTCCGCAGTGACACACGGGGATAGGATTCCTGGGAGTT
TTCGAGTCCGATGGTGACGACACATGGAACTCTTAGTTTCCATACGGTGTCAGCAAAGCC
GAGACAGCGTTCCGAATCTACATGAGAGGCCCTGCGGTCAAGATAAGAGTTTGACGTGTG
TCGGGACTTCCTCTCAATATGGGGAATGGATACCTGGGGTCTGGGCTGGTAGAGGCCGGA
AGTCTCAAACAGGATAGAGAACTTAGAGTTATCTATATCACTTCGGGGATTAGAGGATAT
ATTAGCAACCCACACTCTTCGAAAAGGGTTGGCTTGGCTTTGCATATGTGATGAACTTCT
TACGAAACCGAAATTGTTAGTTAGGTATTCAGGGTACAAGGGTAAGTTGCTCCTAGTCGA
TCTAGAGTCATCTGCTCTAAATACCGAGGGCAAAGCGCTGGTCGTCGAATTGAGAGTTCC
CTGTGGGGATCAAAGGTGGGTACTACGCGGTTGGGAACGGCGAGGACCTATTTATTAAAA
GGGAATGCTATTAAGTGCGCCCTTAATCTTCTACTCCTAGCGAATCGCGGCAAGATTATA
ATCTAGACACTATTCGGGGAGGGTAGGAGTGATGGAAGCAAGGGAGCCTACCTGATTCAC
TCTCTGCCAGCATCTGAGCCTTGGCTAGCTCCACCTACAAGAGTGTTTTTGGAATTTTCA
GCCCACGAGTCGGTTCTTTCGCCAGTGTGGCAGTCGCTCTTGTTAATGAGCGCGGC
>Rosalind_1324
TTCGAGTTCTTTACGAGGCATCGCGCTCCCTGCCCCAGAGGGCCGATTCCATATTAGTAG
GCCAGAGATGATCGTAGTGTAGGAATTGTATCGCAACCCCTTGGCGTCGCATAGATGGGT
CAGCATTCCCTGATGGAGATTAACGTTTGAGAATGTAAGGTAAATATCACACTTGCAAGG
GGTGGCGCGTGAGTCCGACCGGAAGTAGGTGTGATCAAGCATAAACGGCAGGGTACGCCT
GATACGTACTCGCATCAGCGAACAGTATGACCATCTAACGATTCGTAAGGAGAGACGATC
CTATTGGAACGTGGTTCCTGGAAGGTGAATAACGAGATCCCGTGGACCGATCGACGGTAG
GTGGTTGCTATGAATGTACGCGAAGACACACTCTACGTTAAACAACCCATTCACCGAAAC
AGATTCAGAGTCGGGCATGAGGTACGACGCCGACTGCAATTGTTGGTATATGTTTCTGCA
TCGCTATAGCGAGGAGGTTTACTCTAGCCACTTGGAGCCCATGAACGTTATCACTGTTCC
CATCCATGATATCACGCTGATGTCTAAAGGTTAGTAGCTAGTGTTGTTCTACAGTCAAAT
ACGCGTATGTAACGGGTAGATTAGAGGGTGGACACCTTCGGACATCCATACTCATCTTTA
GACCACTCTGCTCCATTTACACACGCTCAAGATTGTTCTTGTTGGATCGGGAATGGAAAT
TAAACCCGGTGAGGAGCCATTCTGTGGGGGGTCACCTCTCTGTCGTCTGTATAGACTCAG
GGCCTTTAAAGCACTCCCGGGAATTACAGGCGCGAACCTCATGTCGGCTATCGTCCTGTA
GCGATCGGGAGCCCCTAACGCTTCGGACAACTGTCCTTCGACTGATTAATACACAGACCT
GGTATCGCCACGGTTATTAAACGATATCCACACAATCCTTGAGCGTAGCTTCTACC
>Rosalind_0991
GAATTGATGTCGAATTGCTGCGTAACGCAAGGGGAGATCCTCTAATGAGCCTACACGAGA
GCATCAGTCACGCCCAGGGCTTCGCACTATAATCCCTTAAGCTAGACCATTATGCTCCCA
CCACCCGAAGGCATGCGGACTTACAGATATGTTCAGCACCAGTACGAGTGCCACTTGTGA
AAGAAGTAAAAACAATTCATCCATGTGGTATCATTGTATGACCGGATCACCATAGAAAGG
TGAGCTGCCCTAACTCAAACGAGGTAAACATTGCGTCACCGCTTACCCGTTATGTAGTCA
TGATAGACTCATTCACTTGCGCCGGGGCCCCGGGACAAACAATAATAGTAATTAAGCACC
GCCTCGGTGTGTACACCTTCGCCGGGGGCATCGATAATTAAGACTTGGTTAAACGGTGCA
TGCGCTGCATGCGGTAGGTCTTTACTGAAATATTCGTTGGTCAAAACTTCGGCAATTGTA
TGTATAGAGAACGGCATACCTAACTCTCCGGGCTACTAATAGCACAAAAGGTCTATGAAT
CATAGTGGGTGGCCTAACATACTGAATGGCCGGTTAGAGTATATAGTCGACGGTGGCGCC
GGGTAACCCGGGGACGCTACCGAACCCGGCGCGATGAATCCTCCCTTTCGCATTGGTCAC
GGCGCGACGTTGAGTTCAATACGGTTAAACGTAACCAGGGGGCGTGGCAGACTGGAGACG
CAAAATCCAACACGAACCCATGTAACAACAGTGTACTTCTTGCTACGTTTCAGGTTTGTT
TTAGAAGCTACCCTCTCTCCAGTTTCGCAGAGACTTCAATCGGTACAGATACCTTCACCT
CGTGATAGAAGAATGAGGCCGGGCTGGGAGAGTGATGTAAGAATAGCCCTTGCTGGCAGT
TGTTATAATCTATTGATTTCGAAACACCTGACCGGTAAGATTTGCTGGTTTTATTG
>Rosalind_1630
GCCTATAATCTCACGACATCTCGCTGGCACGCAGGCATTCCGTACAATACTTTACCATCG
CAACTTTTGTGTGAGGCGATGATCAGTACGCGTGCCCCCTATGTGGATGGTCCCCATAAC
GTATATGATTAGGTGTACCCCTTTCTGGGGGACTTTTAGGAAGTTCGTGAAAGCGCAAAA
ATCTGGACGCTCGCCACCAATATGAGTCCGTTATACTATGTACCGTGACCGCCCTGGGTA
GCTACCCAGTATCCCTAGCTTAGCTTAGAATCTTGTGAAGATGTTCCATGCGTATAGCGT
TATGATGCAGCTGGCTGTCCAGCTACCGGCAGAAAGGCGCTCTATAGTTTAGAGACCGAG
GATTAATCTAACGATGAAAGCGGGGTTATCGCATATATAAAACACTAGGGTGCGAATCAA
GCGATGTACACGCGGGATCGAGAGAACAAAGAGCACATCATAGAAGAGCAGTTCGGGTTG
CACTAGATCGTACGAGGAGTGGAAGGCACTAGGAGTCCAGCGACTTATCGGAGTTCCAAA
TTCCGCCTCACCCCAGAGTTCTTCTTGCTAAGCCGGTGACCTTTATGTAAGAGAGCGTCT
GATCTCTGTCTACAGAGAAGCCTCGCCCGGACTGCGGAAAGACTCTCGCCAATTTCGGCA
CCCACACTAGCTTCTTGTAAATTGGATCGCATTATTGCCGATTCCCACCGGGACGAGCGA
GGCGTCGCCTGACCCCGAATGGGCCTTGACGTCCGCACCGGATAAGGACGGTCGGAAAAT
TAGTGGGAACTCAAGGTTGGCTGATCATTATTGGCCGGTACGTTGTGGTAACGGTGACTA
GTCCTCCTCGTTTGTCTGGCAAAATTTCTAAGTTAGTCCGAATCGGCGGACTACCTAAAG
ATAAGTAAACCCCAGCATTGTCGAATCTACTGGAGGCGTTATTGATCGCCCACCGG
>Rosalind_9081
GATGATCAGATCGTGAGATGCCCGCCTGAAGAATAGCAGCTTAAGTTCGATAGTGGTTGC
CTGAGCATCTTACGGTCAGCTAGGGTGAGGGACGAAAGCCAGATGTATCGAAACCTTTGG
TTATGCGCACACCTTTCAATTCCTCCGAACCCATTCCAGTAAAATAGTTTGCGGGCAGTG
ACAACGGAGAATCATGCCGGGCAATTGGGAGGCACGGTAGGCAATAAAGATCTCTCACTT
CAAATTTCGGTACCACCCGAGCACGGGGGCGCCGAGGAGTGAGCAACACTATTGTTTAAC
GATCGACAGAAAGATTCGCCGTGAGTAGATGACTAATCGAGACACGGAGTTCCAGTTAAC
TATTGGCTTTCAAAACGCCTACGCTTCTTACTGTTCGAGCTAAAAGCCTGCTCCCACATC
GGTCATATTCCGGGTGAGTTTGTCGTCGTAAATTGTTATCAAAAACTAGTACGATCGTCT
GAGTGATGAACGTACGTTGTATCGGGATGACCGTGGGCTAAAGGGGGGATAAATTACAGC
GTTCAACATTCTGGCAACCCAGTGTGACACAAAGACAAATGGTGCTTGCAGATTGATTCA
ACTGTCTTGCACTGTCAGGGAGCAGCCTTCGTAGGTTCTGTAACTGGCAGTCACTGTTAA
TCGATGCAGGTGACACCCCATGGTACGACAGTGAACCCGGTGAAGGGTAAATAACTTGAG
GCGAATTCAGGTCCAATATAGGATCACGCCGAAAAGCGTACAGTCAGGGTTCGGGTCCCT
ATCGACCTTGAACAATTTAAATGATCTACAGCTTGCTATTTGAGCACTGTAATGAATATA
CCAACCTCCTATATAATCCTTGAGAGGTCGAGCGCTGCTACGGGGTGGAACGAATGGCCT
CCGGCTCTTGGAGCAATGGTGGTGGACTTAGCTCATCGGATCGCTCGAGAGATCTA
>Rosalind_0833
AGCGTACAATCGATCCACGTAATTTATACTTATATGAACTATTTAAACAAATTTCTATTT
CTATCTACCACCGCAAGACGCGTGGCCAAAGATCAATGCAATATCCCTGCAACTTGGCCT
CCTCCATCTTTGTTTTTCAGTGGGAATAAATATATGCCAGAAGGTGCTCGGCGTGTGTTC
GCAGACAGCCTTTAACTGCCAGATGGGGCTCTGGAAAATCGTTGGAGGCCGTGACTTATG
TCGCCGCCCACATCAGTTGAATCCTCTAGATTCGTTGAGAATGGCACCATTTGCTGTAAC
GACACGTGTTGATGTTGTCACGCTCCATGAGTACTGGAACCTAGCTTTAACGCGGAAGTA
TTGCGTTTGGGTTAAGTTATTCGTTAGCGTTAAACGTTACTAACGATGAAGTCAACTGAC
ATCTGTACCCGGATAGCCGGGCCAACTGAGCATCGCGATAGTTGCTCTGTTCCATCACTT
ACCGTTGGCTCTCGCTGAACACCTAGCACGCAAGTTATCTCGGATATCTTGCCGCTTCGT
AAGCAGCTATTGCTTGGGTACAGACCAAGCCCATCGGCTTAACCTTCAACTGCAACATGG
CTTAAGACGAGGAATCACGTGTGTGTGTAAATGAGGAGAGGAAGTTTTGGGCCGTACATA
GCTATCCACTTTTAGACGAAGAACCTCTACTGAAAGCTATGCGCACTTCCCGATACTGAG
GCTGATGGCCTGTTTGCAGACGATCGGCTGAGCTGGCCTAACCCAGTTACCAGGTGATTA
AGGTGGGCCTCTAGAGGGCGTTACCTCAGATCGCACTTATACAAAATGTCCTATCCATGT
TGTAGTACGGCACGAATAGAGGACCAATGGCGATTGGGCTGCTATGATCGTTGGTCCACC
GGCATACCTCCCTTCACTGGGAAGTGCACCGCACGAGGCGTTCGTACGCGACGTCA
>Rosalind_5981
ACTCGCGGTTGGACCGAAAACTGATTATTTTGCAATGAGCGACTTCCTGGACAGTTTGCG
CGCATCTTTGGAGTGTCTTGACTAATAACAGCTATTGTTTTCCTAAATACAGAAATACCT
TTAGTAGCCCGGGACCGATGCGAGAAACTGTTACTAGCCTTTAAAACTAGCACCAGACCG
GTGATCAAACTGATAGGCAACGAGGAATGACCGTGTCACGCATATCGAGGCCCTGCAGCT
GCCGCCGAGATGATTGAGTGGATATCCTCTGGAATAGAAACAGGTGTTACTACACAAGGA
TGTTGATAGATCGCAGTGTCACCGCGCACGTGCCCGCTCTGCATGGGTATCAATCCGCCG
TCTGCGAGTAATCTGAGGAAGCCTGAATCAACTGTCGCAGAACTCCCTGCTCTCGTCAAA
TACATGACTCGAGTCTATGGACCTACAGTATAAAATCTCTAATCTTAGCTAGTCGCTCTC
AATGACGCCTCAGCAAGAAAGAGCAGGAGTGTGATTGAAATTATTATGTTGAGTACTGTG
ACAAGAGAATAATACTACGCTCAGACCTAGCCAGTTGAAGGGTTGGAGGGTTGTAACGAC
GATTATGTGCCCTCGAAAATGCACATCGTTAACAGCTCCATGAGTCAGATTCAAATGGAT
AATCTGACGATCAGCATCAGACATCACCTCGTTTTTGCAAGAGCATCAGAAAAAAGAATT
GAATTCCTTTTAAAGCAGGCCCCGTAAACATACAATATCGTAAGCGCAAAGCTCGTGGTT
AGGCTCCAGAGATTATAAGTGCGTCACTGCCGTGCATGCTTTGACCCTTTCTCCGAACTT
AGTTGTTCGATGTCGAGCTAGAAATCAAACCCGCAAAGACGACCCAGGGCTTTTAGTCAG
TTGGGGTCAGGTTTGAATTACTGGAGCAAGAGCGCCTACATCCCGCATCGACGTGG
